╔═╤══╤══╤══╤══╤══╤══╤══╤══╤══╤══╤══╤══╤══╤══╤══╤══╤══╤══╤══╤══╤══╤══╤══╤══╤══╤══╤══╤══╤══╤══╤══╤══╤══╤══╤══╤══╤══╤══╤══╤══╤══╤══╤══╤══╤══╤══╤══╤══╤══╤══╤══╤══╤══╤══╤══╤═╗
║                                                                                                                                                                        ║
╟                                                                                                                                                                        ╢
║                                                                                                                                                                        ║
╟                                                                                                                                                                        ╢
║                                                           █████████████████████████████████████████████████                                                            ║
╟                                                           ██      ██     ██                              ██                                                            ╢
║                                                           ██ ■    ▓█ ██                   ██             ██                                                            ║
╟                                                           ██ ▒░▒ ▓       ██               ██             ██                                                            ╢
║                                                           ██      ██#██  ██████  █████    ██             ██                                                            ║
╟                                                           ██      ###                     ██             ██                                                            ╢
║                                                           ██████████     ░                               ██                                                            ║
╟                                                           ██  ▓▓  ████       █████████    ██             ██                                                            ╢
║                                                           ██                        ██    ██             ██                                                            ║
╟                                                           ████  ████                      ██             ██                                                            ╢
║                                                           ██      ██                ██    ██             ██                                                            ║
╟                                                           ██      █████████         ██    ██████████  █████                                                            ╢
║                                                           ██             ██                   ██         ██                                                            ║
╟                                                           ██████████     ██         ██                   ██                                                            ╢
║                                                           ██      ██     ██         ██    ███████  ████████                                                            ║
╟                                                           ██  ██  █████████         ██    ██             ██                                                            ╢
║                                                           ██  ██  ██     ██         ██    ██             ██                                                            ║
╟                                                           ██  ██████     ██         ██    ██             ██                                                            ╢
║                                                           ██                                             ██                                                            ║
╟                                                           █████████████████████████████████████████████████                                                            ╢
║                                                                                                                                                                        ║
╟                                                                                                                                                                        ╢
║                                                                                                                                                                        ║
╟                                                                                                                                                                        ╢
╚═╧══╧══╧══╧══╧══╧══╧══╧══╧══╧══╧══╧══╧══╧══╧══╧══╧══╧══╧══╧══╧══╧══╧══╧══╧══╧══╧══╧══╧══╧══╧══╧══╧══╧══╧══╧══╧══╧══╧══╧══╧══╧══╧══╧══╧══╧══╧══╧══╧══╧══╧══╧══╧══╧══╧══╧═╝
┌─┬──┬──┬──┬──┬──┬──┬──┬──┬──┬──┬──┬──┬──┬──┬──┬──┬──┬──┬──┬──┬──┬──┬──┬──┬──┬──┬──┬──┬──┬──┬──┬──┬──┬──┬──┬──┬──┬──┬──┬──┬──┬──┬──┬──┬──┬──┬──┬──┬──┬──┬──┬──┬──┬──┬──┬─┐
│                                                                                                                                                                        │
├                                                                                                                                                                        ┤
│                                                                                                                                                                        │
├                                                                                                                                                                        ┤
│                                                                                                                                                                        │
├                                                                                                                                                                        ┤
│                                                                                                                                                                        │
├                                                                                                                                                                        ┤
│                                                                                                                                                                        │
├                                                                                                                                                                        ┤
│                                                                                                                                                                        │
├                                                                                                                                                                        ┤
│                                                                                                                                                                        │
├                                                                                                                                                                        ┤
│                                                                                                                                                                        │
└─┴──┴──┴──┴──┴──┴──┴──┴──┴──┴──┴──┴──┴──┴──┴──┴──┴──┴──┴──┴──┴──┴──┴──┴──┴──┴──┴──┴──┴──┴──┴──┴──┴──┴──┴──┴──┴──┴──┴──┴──┴──┴──┴──┴──┴──┴──┴──┴──┴──┴──┴──┴──┴──┴──┴──┴─┘